15 22
0 0 0 0 0 0 0 0 0 0 0 0 0 0 0 0 0 0 0 0 0 0 
0 0 0 0 0 0 0 0 0 0 0 0 0 0 0 0 0 0 0 0 0 0 
117 117 117 117 117 117 117 117 117 117 117 117 117 117 117 117 117 117 117 117 117 117 
117 117 117 117 117 117 117 117 117 117 117 117 117 117 117 117 117 117 117 117 117 117 
117 117 117 117 117 117 117 117 117 117 117 117 117 117 0 0 0 0 0 117 117 117 
0 0 0 0 0 0 0 0 0 0 0 0 0 0 0 0 0 0 0 0 0 0 
0 0 0 0 0 0 0 0 0 0 0 0 0 0 0 0 0 0 0 0 0 0 
117 117 117 0 0 0 0 0 0 0 0 0 0 0 0 0 0 0 0 0 0 0 
117 117 117 117 0 0 0 0 0 0 0 0 0 0 0 0 0 0 0 0 0 0 
117 117 117 117 117 0 0 0 0 0 0 0 0 0 0 0 0 0 0 0 0 0 
117 117 117 117 117 117 0 0 117 117 117 117 117 0 0 117 117 117 0 0 0 0 
117 117 117 117 117 117 0 0 117 117 117 117 117 0 0 117 117 117 0 0 0 0 
117 117 117 117 117 117 117 117 117 117 117 117 117 0 0 0 117 117 0 0 0 0 
117 117 117 117 117 117 117 117 117 117 117 117 117 0 0 0 0 0 0 0 0 0 
117 117 117 117 117 117 117 117 117 117 117 117 117 0 0 0 0 0 0 0 0 0 
