15 29
0 0 0 0 0 0 0 0 0 0 0 0 0 0 0 0 0 0 0 0 0 0 0 0 0 0 0 0 0 
0 0 0 0 0 0 0 0 0 0 0 0 0 0 0 0 0 0 0 0 0 0 0 0 0 0 0 0 0 
117 117 117 117 117 117 117 117 117 117 117 117 117 117 117 117 117 117 117 117 117 117 117 0 0 0 0 0 0 
117 117 117 117 117 117 117 117 117 117 117 117 117 117 117 117 117 117 117 117 117 117 117 0 0 0 0 0 0 
117 117 117 117 117 117 117 117 117 117 117 117 117 117 0 0 0 0 0 117 117 117 117 0 0 0 0 0 0 
0 0 0 0 0 0 0 0 0 0 0 0 0 0 0 0 0 0 0 0 0 0 0 0 0 0 0 0 0 
0 0 0 0 0 0 0 0 0 0 0 0 0 0 0 0 0 0 0 0 0 0 0 0 0 0 0 0 0 
117 117 117 0 0 0 0 0 0 0 0 0 0 0 0 0 0 0 0 0 0 0 0 0 0 0 0 0 14 
117 117 117 117 0 0 0 0 0 0 0 0 0 0 0 0 0 0 0 0 0 0 0 0 0 0 0 0 14 
117 117 117 117 117 0 0 0 0 0 0 0 0 0 0 0 0 0 0 0 0 0 0 0 0 0 0 14 14 
117 117 117 117 117 117 0 0 117 117 117 117 117 0 0 117 117 117 0 0 0 0 0 0 0 0 14 14 14 
117 117 117 117 117 117 0 0 117 117 117 117 117 0 0 117 117 117 0 0 0 0 0 0 0 0 14 14 14 
117 117 117 117 117 117 117 117 117 117 117 117 117 0 0 0 117 117 0 0 0 0 0 0 0 0 14 14 14 
117 117 117 117 117 117 117 117 117 117 117 117 117 0 0 0 0 0 0 0 0 0 0 0 0 0 0 0 0 
117 117 117 117 117 117 117 117 117 117 117 117 117 0 0 0 0 0 0 0 0 0 0 0 0 0 0 0 0 
