13 31
117 117 117 117 117 117 117 117 117 117 117 117 117 117 117 117 117 117 117 117 117 117 117 0 0 0 0 0 0 0 0 
117 117 117 117 117 117 117 117 117 117 117 117 117 117 117 117 117 117 117 117 117 117 117 0 0 0 0 0 0 0 0 
117 117 117 117 117 117 117 117 117 117 117 117 117 117 117 117 117 117 117 117 117 117 117 0 0 0 0 0 0 14 14 
0 0 0 0 44 0 44 0 44 44 44 0 44 0 44 0 44 44 44 0 0 0 0 0 0 0 0 0 0 14 14 
0 0 0 0 44 44 44 0 44 0 44 0 44 44 44 0 44 0 44 0 0 0 0 0 0 0 0 0 0 14 0 
117 117 117 0 44 0 44 0 44 44 44 0 44 0 44 0 44 44 44 0 0 0 0 0 0 0 0 0 14 14 14 
117 117 117 117 0 0 0 0 0 0 0 0 0 0 0 0 0 0 0 0 0 0 0 0 0 0 0 0 14 0 0 
117 117 117 117 117 0 0 0 0 0 0 0 0 0 0 0 0 0 0 0 0 0 0 0 0 0 0 14 14 0 0 
117 117 117 117 117 117 117 117 117 117 117 117 117 0 0 117 117 117 0 0 0 0 0 0 0 0 14 14 14 0 0 
117 117 117 117 117 117 117 117 117 117 117 117 117 0 0 117 117 117 0 0 0 0 0 0 0 0 14 14 14 0 0 
117 117 117 117 117 117 117 117 117 117 117 117 117 0 0 0 117 117 0 0 0 0 0 0 0 0 14 14 14 0 0 
117 117 117 117 117 117 117 117 117 117 117 117 117 0 0 0 0 0 0 0 0 0 0 0 0 0 0 0 0 0 0 
117 117 117 117 117 117 117 117 117 117 117 117 117 0 0 0 0 0 0 0 0 0 0 0 0 0 0 0 0 0 0 
