13 14
0 0 0 0 0 0 0 0 0 0 0 0 0 0 
0 0 0 0 0 0 0 0 0 0 0 0 0 0 
0 0 0 0 0 0 0 0 0 0 0 0 0 0 
0 0 0 0 0 0 0 0 0 0 0 0 0 0 
0 0 0 0 0 0 0 0 0 0 0 0 0 0 
0 0 0 0 0 0 0 0 0 0 0 0 0 0 
0 0 0 0 0 0 0 0 0 0 0 0 0 0 
0 0 0 0 0 0 0 0 0 0 0 0 0 0 
0 0 0 0 0 0 0 0 0 0 0 0 0 0 
229 230 0 0 0 0 0 0 0 0 0 229 230 0 
253 254 0 229 230 0 0 229 230 0 0 253 254 0 
1 1 0 253 254 0 0 253 254 0 1 1 1 1 
1 1 1 1 1 1 1 1 1 1 1 1 1 1 
