15 210
0 0 0 0 0 0 0 0 0 0 0 0 0 0 0 0 0 0 0 0 0 0 0 0 0 0 0 0 0 0 0 0 0 0 0 0 0 0 0 0 0 0 0 0 0 0 0 0 0 0 0 0 0 0 0 0 0 0 0 0 0 0 0 0 0 0 0 0 0 0 0 0 0 0 0 0 0 0 0 0 0 0 0 0 0 0 0 0 0 0 0 0 0 0 0 0 0 0 0 0 0 0 0 0 0 0 0 0 0 0 0 0 0 0 0 0 0 0 0 0 0 0 0 0 0 0 0 0 0 0 0 0 0 0 0 0 0 0 0 0 0 0 0 0 0 0 0 0 0 0 0 0 0 0 0 0 0 0 0 0 0 0 0 0 0 0 0 0 0 0 0 0 0 0 0 0 0 0 0 0 0 0 0 0 0 0 0 0 0 0 0 0 0 0 0 0 0 0 0 0 0 0 0 0 0 0 0 0 0 0 
0 0 0 0 0 0 0 0 0 0 0 0 0 0 0 0 0 0 0 0 0 0 0 0 0 0 0 0 0 0 0 0 0 0 0 0 0 0 0 0 0 0 0 0 0 0 0 0 0 0 0 0 0 0 0 0 0 0 0 0 0 0 0 0 0 0 0 0 0 0 0 0 0 0 0 0 0 0 0 0 0 0 0 0 0 0 0 0 0 0 0 0 0 0 0 0 0 0 0 0 0 0 0 0 0 0 0 0 0 0 0 0 0 0 0 0 0 0 0 0 0 0 0 0 0 0 0 0 0 0 0 0 0 0 0 0 0 0 0 0 0 0 0 0 0 0 0 0 0 0 0 0 0 0 0 0 0 0 0 0 0 0 0 0 0 0 0 0 0 0 0 0 0 0 0 0 0 0 0 0 0 0 0 0 0 0 0 0 0 0 0 0 0 0 0 0 0 0 0 0 0 0 0 0 0 0 0 0 0 0 
0 0 0 0 0 0 0 0 0 0 0 0 0 0 0 0 0 0 23 24 24 25 0 0 0 0 0 0 0 0 0 0 0 0 0 0 0 51 51 0 0 0 0 0 0 0 0 0 0 0 0 0 0 0 0 0 0 0 0 0 0 0 0 0 0 0 23 24 24 25 0 0 0 0 0 0 0 0 0 0 0 0 0 0 0 0 0 0 0 0 0 0 0 0 0 0 0 0 0 0 0 0 0 0 0 0 0 0 0 0 0 0 0 0 23 24 24 25 0 0 0 0 0 0 0 0 0 0 0 0 0 0 0 0 0 0 0 0 0 0 0 0 0 0 0 0 0 0 0 0 0 0 0 0 0 0 0 0 9 9 9 0 23 24 0 0 0 0 0 0 0 0 0 0 0 0 0 0 0 0 0 0 23 24 24 25 0 0 0 0 0 0 0 0 0 0 0 0 0 0 0 51 51 0 0 0 0 0 0 0 
0 0 0 23 24 24 25 0 0 0 0 0 0 0 0 0 0 0 53 54 54 55 0 0 0 0 0 0 0 0 0 0 0 0 0 0 0 0 0 0 0 0 0 0 0 0 0 0 0 0 0 23 24 24 25 0 0 0 0 0 0 0 0 0 0 0 53 54 54 55 0 0 0 0 0 0 0 0 0 0 0 0 0 0 0 0 0 0 0 0 0 0 0 0 0 0 0 0 0 23 24 24 25 0 0 0 0 0 0 0 0 0 0 0 53 54 54 55 0 0 0 0 0 0 0 0 0 0 0 0 0 0 0 0 0 0 0 0 0 0 0 0 0 0 0 0 0 23 24 24 25 0 0 0 0 0 0 0 11 12 13 0 0 54 0 0 0 23 24 24 25 0 0 0 0 0 0 0 0 0 0 0 53 54 54 55 0 0 0 0 0 0 0 0 0 0 0 0 0 0 0 0 0 0 0 0 0 0 0 0 
0 0 0 53 54 54 55 0 0 0 0 0 0 0 0 0 0 0 0 0 0 0 0 0 0 0 0 51 51 51 0 0 0 0 0 0 0 0 0 0 234 235 235 235 235 235 236 0 0 0 0 53 54 54 55 0 0 0 0 0 51 51 51 51 0 0 0 0 0 0 0 0 0 0 0 0 0 0 0 0 0 0 0 0 0 0 0 0 0 0 0 0 0 51 51 0 0 51 51 53 54 54 55 0 0 0 0 0 0 0 0 0 0 0 0 0 0 0 0 0 0 0 0 0 0 0 0 0 0 0 0 0 0 0 0 0 0 0 0 0 0 0 0 0 0 0 0 53 54 54 55 0 0 0 0 0 0 9 10 10 10 9 0 0 0 0 0 53 54 54 55 0 0 0 0 0 0 0 0 0 0 0 0 0 0 0 0 0 0 0 0 51 51 51 0 0 0 0 0 0 0 0 0 0 234 235 235 235 235 235 
0 0 0 0 0 0 0 0 0 0 0 0 0 0 0 0 0 0 0 0 0 0 0 0 0 0 234 235 235 235 236 0 0 0 0 0 0 0 0 0 0 47 47 47 47 47 0 0 0 0 0 0 0 0 0 0 0 0 0 0 234 235 235 236 0 0 0 0 0 0 0 0 0 0 0 0 0 0 0 0 0 0 0 0 0 51 51 0 0 0 0 0 0 0 0 0 0 0 0 0 0 0 0 0 0 0 0 0 0 0 0 0 0 0 0 0 0 0 0 0 51 51 0 0 0 0 0 0 0 0 0 0 0 0 0 0 0 0 0 0 0 0 31 31 0 0 0 0 0 0 0 0 0 0 0 0 0 12 12 15 12 12 0 0 0 0 0 0 0 0 0 0 0 0 0 0 0 0 0 0 0 0 0 0 0 0 0 0 0 0 234 235 235 235 236 0 0 0 0 0 0 0 0 0 0 47 47 47 47 47 
0 0 0 0 0 0 0 0 0 0 0 0 0 0 0 0 0 0 0 0 0 0 0 0 0 0 0 47 47 47 0 0 0 0 0 0 0 0 23 24 25 47 47 47 47 47 0 0 0 0 51 51 0 0 0 28 29 30 0 0 0 47 47 0 0 0 0 0 0 0 0 0 0 0 0 0 234 235 235 235 235 236 0 0 0 0 23 24 25 0 0 0 0 0 0 0 0 0 0 0 0 0 0 0 0 0 0 0 0 0 0 0 0 0 0 0 0 0 0 0 0 0 0 0 0 0 0 0 0 0 0 28 29 30 23 24 25 0 0 0 0 0 31 31 0 0 0 0 0 0 0 0 0 0 0 0 0 12 12 14 12 12 0 0 0 0 0 0 0 0 0 0 0 0 0 0 0 0 0 0 0 0 0 0 0 0 0 0 0 0 0 47 47 47 0 0 0 0 0 0 0 0 23 24 25 47 47 47 47 47 
0 0 0 0 0 0 0 0 0 23 24 25 0 0 0 0 0 0 0 0 0 0 0 0 0 0 0 47 47 47 0 0 0 0 0 23 24 25 53 54 55 47 47 47 47 47 0 0 0 0 0 0 0 0 0 0 0 23 24 25 0 47 47 0 0 0 0 0 0 0 0 0 0 0 0 0 0 47 47 47 47 0 0 23 24 25 53 54 55 0 0 0 0 0 0 0 0 0 0 0 0 0 0 0 234 235 235 235 235 235 235 236 0 0 0 0 0 0 0 0 0 0 0 0 0 0 0 0 0 0 0 23 24 25 53 54 55 0 0 0 31 31 31 31 0 0 0 0 0 0 0 0 0 23 24 9 9 10 10 10 10 10 9 9 0 0 0 0 0 0 0 0 0 23 24 25 0 0 0 0 0 0 0 0 0 0 0 0 0 0 0 47 47 47 0 0 0 0 0 23 24 25 53 54 55 47 47 47 47 47 
0 9 9 9 0 0 0 0 0 53 54 55 0 0 0 0 0 0 0 0 0 0 0 0 0 0 0 47 47 47 0 0 0 0 0 234 235 235 235 236 0 47 47 47 47 47 0 0 0 0 0 0 0 0 0 0 0 53 54 55 0 47 47 0 0 0 0 0 0 0 0 0 0 0 0 0 0 47 47 47 47 0 0 53 54 55 28 29 30 0 0 0 0 0 0 0 0 0 0 0 0 0 0 0 0 47 47 47 47 47 47 0 0 0 0 0 0 0 0 0 0 0 0 0 0 0 0 0 0 0 0 53 54 55 0 0 0 0 0 0 31 31 31 31 0 0 0 0 0 0 0 0 0 53 54 12 12 12 15 12 15 12 12 12 0 9 9 9 0 0 0 0 0 53 54 55 0 0 0 0 0 0 0 0 0 0 0 0 0 0 0 47 47 47 0 0 0 0 0 234 235 235 235 236 0 47 47 47 47 47 
0 11 12 13 0 0 0 0 0 0 0 0 0 0 0 0 0 0 0 0 0 0 0 0 234 235 235 235 235 235 235 235 236 0 0 0 47 47 47 0 0 47 47 47 47 47 0 0 0 0 0 0 0 0 0 0 0 0 0 0 0 47 47 0 0 0 0 0 0 0 234 235 236 0 0 0 0 47 47 47 47 0 0 0 0 0 0 0 0 0 0 0 0 0 28 29 30 0 0 0 0 0 0 0 0 47 47 47 47 47 47 0 0 0 0 0 234 235 235 236 0 0 234 235 235 236 0 0 0 0 0 0 0 0 0 0 0 0 31 31 31 31 31 31 0 0 0 0 0 0 0 0 0 0 0 12 12 12 14 12 14 12 12 12 0 11 12 13 0 0 0 0 0 0 0 0 0 0 0 0 0 0 0 0 0 0 0 0 234 235 235 235 235 235 235 236 0 0 0 0 47 47 47 0 0 47 47 47 47 47 
9 10 10 10 9 0 0 0 0 0 0 0 0 0 0 0 0 0 0 0 0 0 0 0 0 47 47 47 47 47 47 0 0 0 0 0 47 47 47 0 0 47 47 47 47 47 0 0 0 0 0 0 0 0 0 0 0 0 0 20 0 47 47 0 0 0 0 0 0 0 0 47 0 0 0 0 0 47 47 47 47 0 0 0 0 0 0 0 0 0 0 0 0 0 0 0 0 0 0 0 0 0 0 0 0 47 47 47 47 47 47 0 0 0 0 0 0 47 47 0 0 0 0 47 47 0 0 0 0 0 0 0 0 0 0 0 0 0 31 31 31 31 31 31 0 0 0 0 0 0 0 0 0 0 0 12 12 12 12 12 12 12 12 12 9 10 10 10 9 0 0 0 0 0 0 0 0 0 0 0 0 0 0 0 0 0 0 0 0 47 47 47 47 47 47 0 0 0 0 0 47 47 47 0 0 47 47 47 47 47 
12 12 15 12 12 0 0 0 0 0 0 0 0 0 0 0 0 0 0 0 0 0 0 0 0 47 47 47 47 47 47 0 0 51 0 0 47 47 47 0 0 47 47 47 47 47 23 24 25 0 0 0 0 0 0 0 0 0 0 0 0 47 47 0 0 0 0 0 0 0 0 47 0 0 0 0 0 47 47 47 47 0 0 0 0 0 0 0 0 0 0 0 0 0 23 24 25 0 234 235 235 236 0 0 0 47 47 47 47 47 47 0 0 0 0 0 0 47 47 0 0 0 0 47 47 24 25 0 0 0 0 0 0 0 0 0 0 0 31 31 31 31 31 31 25 0 0 0 0 0 0 0 0 0 0 12 12 15 12 15 12 15 12 12 12 12 15 12 12 0 0 0 0 0 0 0 0 0 0 0 0 0 0 0 0 0 0 0 0 47 47 47 47 47 47 0 0 51 0 0 47 47 47 0 0 47 47 47 47 47 
12 12 14 12 12 0 0 0 0 0 0 0 0 0 0 0 0 0 234 235 235 236 0 0 0 47 47 47 47 47 47 0 234 235 236 0 47 47 47 0 0 47 47 47 47 47 53 54 55 0 0 0 0 0 0 0 0 0 0 0 0 47 47 0 0 0 0 0 0 0 0 47 0 0 0 0 0 47 47 47 47 0 0 0 0 0 0 0 0 0 0 0 0 0 53 54 55 0 0 47 47 0 0 0 0 47 47 47 47 47 47 0 0 51 51 51 0 47 47 0 0 0 0 47 47 54 55 0 0 0 0 0 0 0 0 0 0 0 31 31 31 31 31 31 55 0 0 0 0 0 0 0 31 0 0 12 12 14 12 14 12 14 12 12 12 12 14 12 12 0 0 0 0 0 0 0 0 0 0 0 0 0 234 235 235 236 0 0 0 47 47 47 47 47 47 0 234 235 236 0 47 47 47 0 0 47 47 47 47 47 
1 1 1 1 1 1 1 1 1 1 1 1 1 1 1 1 0 0 0 47 47 0 0 0 0 47 47 47 47 47 47 0 0 47 0 0 47 47 47 0 0 47 47 47 47 47 0 0 0 0 234 235 235 236 0 0 0 0 0 234 235 235 235 236 0 234 235 235 235 236 0 47 0 0 0 0 0 47 47 47 47 0 0 0 0 0 0 0 0 0 0 0 0 0 0 0 0 0 0 47 47 0 0 0 0 47 47 47 47 47 47 0 0 234 235 236 0 47 47 0 0 0 0 47 47 0 0 0 0 1 1 1 1 1 1 1 1 1 1 1 1 1 1 1 1 1 1 1 1 1 1 1 1 1 1 1 1 1 1 1 1 1 1 1 1 1 1 1 1 1 1 1 1 1 1 1 1 1 1 1 0 0 0 47 47 0 0 0 0 47 47 47 47 47 47 0 0 47 0 0 47 47 47 0 0 47 47 47 47 47 
1 1 1 1 1 1 1 1 1 1 1 1 1 1 1 1 0 0 0 47 47 0 0 0 0 47 47 47 47 47 47 0 0 47 0 0 47 47 47 0 0 47 47 47 47 47 0 0 0 0 0 47 47 0 0 0 0 0 0 0 47 47 47 0 0 0 47 47 47 0 0 47 0 0 0 0 0 47 47 47 47 0 0 0 0 0 0 0 0 0 0 0 0 0 0 0 0 0 0 47 47 0 0 0 0 47 47 47 47 47 47 0 0 0 47 0 0 47 47 0 0 0 0 47 47 0 0 0 0 1 1 1 1 1 1 1 1 1 1 1 1 1 1 1 1 1 1 1 1 1 1 1 1 1 1 1 1 1 1 1 1 1 1 1 1 1 1 1 1 1 1 1 1 1 1 1 1 1 1 1 0 0 0 47 47 0 0 0 0 47 47 47 47 47 47 0 0 47 0 0 47 47 47 0 0 47 47 47 47 47 
